abjectement	abjectement	Adv
abominablement	abominablement	Adv
abondamment	abondamment	Adv
abreviativement	abreviativement	Adv
abruptement	abruptement	Adv
absolument	absolument	Adv
abstraitement	abstraitement	Adv
abusivement	abusivement	Adv
academiquement	academiquement	Adv
accelerando	accelerando	Adv
accessoirement	accessoirement	Adv
accidentellement	accidentellement	Adv
acrement	acrement	Adv
acrimonieusement	acrimonieusement	Adv
acrobatiquement	acrobatiquement	Adv
activement	activement	Adv
actuellement	actuellement	Adv
adagio	adagio	Adv
adequatement	adequatement	Adv
adiabatiquement	adiabatiquement	Adv
adjectivement	adjectivement	Adv
administrativement	administrativement	Adv
admirablement	admirablement	Adv
admirativement	admirativement	Adv
adorablement	adorablement	Adv
adroitement	adroitement	Adv
adverbialement	adverbialement	Adv
affablement	affablement	Adv
affectueusement	affectueusement	Adv
affinement	affinement	Adv
affirmativement	affirmativement	Adv
affreusement	affreusement	Adv
agilement	agilement	Adv
agitato	agitato	Adv
agreablement	agreablement	Adv
agressivement	agressivement	Adv
aigrement	aigrement	Adv
ailleurs	ailleurs	Adv
aimablement	aimablement	Adv
ainsi	ainsi	Adv
aisement	aisement	Adv
alentour	alentour	Adv
alertement	alertement	Adv
algebriquement	algebriquement	Adv
alias	alias	Adv
allegoriquement	allegoriquement	Adv
allegrement	allegrement	Adv
allegrement	allegrement	Adv
allegretto	allegretto	Adv
allegro	allegro	Adv
allusivement	allusivement	Adv
alors	alors	Adv
alphabetiquement	alphabetiquement	Adv
alternativement	alternativement	Adv
altierement	altierement	Adv
ambigument	ambigument	Adv
ambitieusement	ambitieusement	Adv
amerement	amerement	Adv
amicalement	amicalement	Adv
amoroso	amoroso	Adv
amoureusement	amoureusement	Adv
amplement	amplement	Adv
analogiquement	analogiquement	Adv
analytiquement	analytiquement	Adv
anarchiquement	anarchiquement	Adv
anatomiquement	anatomiquement	Adv
anciennement	anciennement	Adv
andante	andante	Adv
andantino	andantino	Adv
annuellement	annuellement	Adv
anonymement	anonymement	Adv
anormalement	anormalement	Adv
anterieurement	anterieurement	Adv
anticonstitutionnellement	anticonstitutionnellement	Adv
antiquement	antiquement	Adv
anxieusement	anxieusement	Adv
apathiquement	apathiquement	Adv
apostoliquement	apostoliquement	Adv
apparemment	apparemment	Adv
appassionato	appassionato	Adv
approbativement	approbativement	Adv
approchant	approchant	Adv
approximativement	approximativement	Adv
aprement	aprement	Adv
apres	apres	Adv
apres-demain	apres-demain	Adv
arbitrairement	arbitrairement	Adv
architectoniquement	architectoniquement	Adv
ardemment	ardemment	Adv
aristocratiquement	aristocratiquement	Adv
arithmetiquement	arithmetiquement	Adv
arriere	arriere	Adv
arrogamment	arrogamment	Adv
artificiellement	artificiellement	Adv
artificieusement	artificieusement	Adv
artisanalement	artisanalement	Adv
artistement	artistement	Adv
artistiquement	artistiquement	Adv
assai	assai	Adv
assez	assez	Adv
assidument	assidument	Adv
assurement	assurement	Adv
astronomiquement	astronomiquement	Adv
astucieusement	astucieusement	Adv
asymptotiquement	asymptotiquement	Adv
atrocement	atrocement	Adv
attenant	attenant	Adv
attentivement	attentivement	Adv
aucunement	aucunement	Adv
audacieusement	audacieusement	Adv
aujourd'hui	aujourd'hui	Adv
auparavant	auparavant	Adv
aupres	aupres	Adv
aussi	aussi	Adv
aussitot	aussitot	Adv
austerement	austerement	Adv
autant	autant	Adv
authentiquement	authentiquement	Adv
automatiquement	automatiquement	Adv
autrefois	autrefois	Adv
autrement	autrement	Adv
auxiliairement	auxiliairement	Adv
au-dedans	au-dedans	Adv
au-dehors	au-dehors	Adv
au-dessous	au-dessous	Adv
au-dessus	au-dessus	Adv
au-devant	au-devant	Adv
avantageusement	avantageusement	Adv
avant	avant	Adv
avant-hier	avant-hier	Adv
avec	avec	Adv
aventureusement	aventureusement	Adv
aveuglement	aveuglement	Adv
avidement	avidement	Adv
banalement	banalement	Adv
bas	bas	Adv
bassement	bassement	Adv
beatement	beatement	Adv
beau	beau	Adv
beaucoup	beaucoup	Adv
bellement	bellement	Adv
ben	ben	Adv
bene	bene	Adv
benevolement	benevolement	Adv
benignement	benignement	Adv
benoitement	benoitement	Adv
besef	besef	Adv
besogneusement	besogneusement	Adv
bestialement	bestialement	Adv
betement	betement	Adv
bezef	bezef	Adv
bien	bien	Adv
bientot	bientot	Adv
bienveillamment	bienveillamment	Adv
bigrement	bigrement	Adv
bilateralement	bilateralement	Adv
bis	bis	Adv
bizarrement	bizarrement	Adv
bon	bon	Adv
bonnement	bonnement	Adv
bougrement	bougrement	Adv
bourgeoisement	bourgeoisement	Adv
bravement	bravement	Adv
bref	bref	Adv
brievement	brievement	Adv
brillamment	brillamment	Adv
brusquement	brusquement	Adv
brutalement	brutalement	Adv
brut	brut	Adv
bruyamment	bruyamment	Adv
burlesquement	burlesquement	Adv
ca	ca	Adv
cahin-caha	cahin-caha	Adv
calinement	calinement	Adv
calmement	calmement	Adv
calomnieusement	calomnieusement	Adv
candidement	candidement	Adv
canoniquement	canoniquement	Adv
cantabile	cantabile	Adv
capricieusement	capricieusement	Adv
captieusement	captieusement	Adv
carrement	carrement	Adv
cash	cash	Adv
categoriquement	categoriquement	Adv
cavalierement	cavalierement	Adv
ceans	ceans	Adv
censement	censement	Adv
cependant	cependant	Adv
ceremonieusement	ceremonieusement	Adv
certainement	certainement	Adv
certes	certes	Adv
chaleureusement	chaleureusement	Adv
charitablement	charitablement	Adv
charnellement	charnellement	Adv
chastement	chastement	Adv
chaud	chaud	Adv
chaudement	chaudement	Adv
cher	cher	Adv
cherement	cherement	Adv
chetivement	chetivement	Adv
chouettement	chouettement	Adv
chretiennement	chretiennement	Adv
chroniquement	chroniquement	Adv
chronologiquement	chronologiquement	Adv
cinematographiquement	cinematographiquement	Adv
cinquiemement	cinquiemement	Adv
circulairement	circulairement	Adv
civilement	civilement	Adv
ci-apres	ci-apres	Adv
ci-contre	ci-contre	Adv
ci-dessous	ci-dessous	Adv
ci-dessus	ci-dessus	Adv
ci-git	ci-git	Adv
ci-inclus	ci-inclus	Adv
ci-joint	ci-joint	Adv
clairement	clairement	Adv
clandestinement	clandestinement	Adv
classiquement	classiquement	Adv
cliniquement	cliniquement	Adv
clopin-clopant	clopin-clopant	Adv
collectivement	collectivement	Adv
colossalement	colossalement	Adv
comiquement	comiquement	Adv
comment	comment	Adv
commercialement	commercialement	Adv
commodement	commodement	Adv
communement	communement	Adv
comparativement	comparativement	Adv
compendieusement	compendieusement	Adv
complaisamment	complaisamment	Adv
completement	completement	Adv
comptant	comptant	Adv
concentriquement	concentriquement	Adv
concretement	concretement	Adv
concurremment	concurremment	Adv
conditionnellement	conditionnellement	Adv
confer	confer	Adv
confidentiellement	confidentiellement	Adv
conformement	conformement	Adv
confortablement	confortablement	Adv
confraternellement	confraternellement	Adv
confusement	confusement	Adv
conjecturalement	conjecturalement	Adv
conjointement	conjointement	Adv
conjugalement	conjugalement	Adv
consciemment	consciemment	Adv
consciencieusement	consciencieusement	Adv
consecutivement	consecutivement	Adv
consequemment	consequemment	Adv
considerablement	considerablement	Adv
constamment	constamment	Adv
constitutionnellement	constitutionnellement	Adv
continuellement	continuellement	Adv
continument	continument	Adv
contradictoirement	contradictoirement	Adv
contrairement	contrairement	Adv
contre	contre	Adv
convenablement	convenablement	Adv
conventionnellement	conventionnellement	Adv
conventuellement	conventuellement	Adv
convulsivement	convulsivement	Adv
copieusement	copieusement	Adv
coquettement	coquettement	Adv
cordialement	cordialement	Adv
correct	correct	Adv
correctement	correctement	Adv
correlativement	correlativement	Adv
couci-couca	couci-couca	Adv
courageusement	courageusement	Adv
couramment	couramment	Adv
court	court	Adv
courtement	courtement	Adv
courtoisement	courtoisement	Adv
couteusement	couteusement	Adv
craintivement	craintivement	Adv
cranement	cranement	Adv
crapuleusement	crapuleusement	Adv
crescendo	crescendo	Adv
criminellement	criminellement	Adv
cruellement	cruellement	Adv
crument	crument	Adv
culinairement	culinairement	Adv
cumulativement	cumulativement	Adv
cupidement	cupidement	Adv
curieusement	curieusement	Adv
cursivement	cursivement	Adv
cyniquement	cyniquement	Adv
dangereusement	dangereusement	Adv
davantage	davantage	Adv
debilement	debilement	Adv
debonnairement	debonnairement	Adv
debout	debout	Adv
decemment	decemment	Adv
decidement	decidement	Adv
decisivement	decisivement	Adv
decorativement	decorativement	Adv
dedaigneusement	dedaigneusement	Adv
dedans	dedans	Adv
defavorablement	defavorablement	Adv
defectueusement	defectueusement	Adv
defensivement	defensivement	Adv
definitivement	definitivement	Adv
degoutamment	degoutamment	Adv
dehors	dehors	Adv
deja	deja	Adv
deliberement	deliberement	Adv
delicatement	delicatement	Adv
delicieusement	delicieusement	Adv
deloyalement	deloyalement	Adv
demain	demain	Adv
demesurement	demesurement	Adv
democratiquement	democratiquement	Adv
demonstrativement	demonstrativement	Adv
deplorablement	deplorablement	Adv
depuis	depuis	Adv
deraisonnablement	deraisonnablement	Adv
derechef	derechef	Adv
derisoirement	derisoirement	Adv
dernierement	dernierement	Adv
derriere	derriere	Adv
desagreablement	desagreablement	Adv
desastreusement	desastreusement	Adv
desavantageusement	desavantageusement	Adv
desesperement	desesperement	Adv
deshonnetement	deshonnetement	Adv
desormais	desormais	Adv
despotiquement	despotiquement	Adv
detestablement	detestablement	Adv
deuxiemement	deuxiemement	Adv
devant	devant	Adv
devotement	devotement	Adv
dextrorsum	dextrorsum	Adv
diablement	diablement	Adv
diaboliquement	diaboliquement	Adv
dialectiquement	dialectiquement	Adv
diametralement	diametralement	Adv
diantrement	diantrement	Adv
diatoniquement	diatoniquement	Adv
dictatorialement	dictatorialement	Adv
didactiquement	didactiquement	Adv
differemment	differemment	Adv
difficilement	difficilement	Adv
diffusement	diffusement	Adv
dignement	dignement	Adv
dilatoirement	dilatoirement	Adv
diligemment	diligemment	Adv
dimanche	dimanche	Adv
diminuendo	diminuendo	Adv
diplomatiquement	diplomatiquement	Adv
directement	directement	Adv
disciplinairement	disciplinairement	Adv
discourtoisement	discourtoisement	Adv
discretement	discretement	Adv
disertement	disertement	Adv
dispendieusement	dispendieusement	Adv
distinctement	distinctement	Adv
distraitement	distraitement	Adv
dito	dito	Adv
diversement	diversement	Adv
divinement	divinement	Adv
dixiemement	dixiemement	Adv
dix-huitiemement	dix-huitiemement	Adv
dix-neuviemement	dix-neuviemement	Adv
dix-septiemement	dix-septiemement	Adv
docilement	docilement	Adv
doctement	doctement	Adv
doctoralement	doctoralement	Adv
dogmatiquement	dogmatiquement	Adv
dolce	dolce	Adv
dolcissimo	dolcissimo	Adv
donc	donc	Adv
dorenavant	dorenavant	Adv
doublement	doublement	Adv
doucement	doucement	Adv
doucereusement	doucereusement	Adv
doucettement	doucettement	Adv
douillettement	douillettement	Adv
douloureusement	douloureusement	Adv
douteusement	douteusement	Adv
doux	doux	Adv
douziemement	douziemement	Adv
dramatiquement	dramatiquement	Adv
droit	droit	Adv
droitement	droitement	Adv
drolement	drolement	Adv
dru	dru	Adv
dubitativement	dubitativement	Adv
dument	dument	Adv
durablement	durablement	Adv
dur	dur	Adv
durement	durement	Adv
dynamiquement	dynamiquement	Adv
ecclesiastiquement	ecclesiastiquement	Adv
ecologiquement	ecologiquement	Adv
economiquement	economiquement	Adv
effectivement	effectivement	Adv
efficacement	efficacement	Adv
effrontement	effrontement	Adv
effroyablement	effroyablement	Adv
egalement	egalement	Adv
egoistement	egoistement	Adv
electivement	electivement	Adv
electoralement	electoralement	Adv
electriquement	electriquement	Adv
elegamment	elegamment	Adv
elliptiquement	elliptiquement	Adv
elogieusement	elogieusement	Adv
eloquemment	eloquemment	Adv
eminemment	eminemment	Adv
emphatiquement	emphatiquement	Adv
empiriquement	empiriquement	Adv
encore	encore	Adv
energiquement	energiquement	Adv
enfin	enfin	Adv
enigmatiquement	enigmatiquement	Adv
ennuyeusement	ennuyeusement	Adv
enormement	enormement	Adv
ensemble	ensemble	Adv
ensuite	ensuite	Adv
entierement	entierement	Adv
entre-temps	entre-temps	Adv
envieusement	envieusement	Adv
environ	environ	Adv
epais	epais	Adv
epatamment	epatamment	Adv
eperdument	eperdument	Adv
episodiquement	episodiquement	Adv
epouvantablement	epouvantablement	Adv
equitablement	equitablement	Adv
erotiquement	erotiquement	Adv
erronement	erronement	Adv
espressivo	espressivo	Adv
essentiellement	essentiellement	Adv
esthetiquement	esthetiquement	Adv
eternellement	eternellement	Adv
etonnamment	etonnamment	Adv
etourdiment	etourdiment	Adv
etrangement	etrangement	Adv
etroitement	etroitement	Adv
etymologiquement	etymologiquement	Adv
euphemiquement	euphemiquement	Adv
euphoniquement	euphoniquement	Adv
evangeliquement	evangeliquement	Adv
evasivement	evasivement	Adv
eventuellement	eventuellement	Adv
evidemment	evidemment	Adv
exactement	exactement	Adv
exagerement	exagerement	Adv
excellemment	excellemment	Adv
excentriquement	excentriquement	Adv
exceptionnellement	exceptionnellement	Adv
excessivement	excessivement	Adv
exclusivement	exclusivement	Adv
execrablement	execrablement	Adv
executoirement	executoirement	Adv
exemplairement	exemplairement	Adv
exhaustivement	exhaustivement	Adv
expeditivement	expeditivement	Adv
experimentalement	experimentalement	Adv
expertement	expertement	Adv
explicitement	explicitement	Adv
exponentiellement	exponentiellement	Adv
expres	expres	Adv
expressement	expressement	Adv
expressivement	expressivement	Adv
exquisement	exquisement	Adv
extemporanement	extemporanement	Adv
exterieurement	exterieurement	Adv
extrajudiciairement	extrajudiciairement	Adv
extraordinairement	extraordinairement	Adv
extremement	extremement	Adv
extrinsequement	extrinsequement	Adv
fabuleusement	fabuleusement	Adv
facetieusement	facetieusement	Adv
facheusement	facheusement	Adv
facile	facile	Adv
facilement	facilement	Adv
facticement	facticement	Adv
facultativement	facultativement	Adv
fadement	fadement	Adv
faiblement	faiblement	Adv
fallacieusement	fallacieusement	Adv
fameusement	fameusement	Adv
familierement	familierement	Adv
fanatiquement	fanatiquement	Adv
fantastiquement	fantastiquement	Adv
farouchement	farouchement	Adv
fastidieusement	fastidieusement	Adv
fastueusement	fastueusement	Adv
fatalement	fatalement	Adv
faussement	faussement	Adv
fautivement	fautivement	Adv
faux	faux	Adv
favorablement	favorablement	Adv
febrilement	febrilement	Adv
feeriquement	feeriquement	Adv
femininement	femininement	Adv
feodalement	feodalement	Adv
ferme	ferme	Adv
fermement	fermement	Adv
ferocement	ferocement	Adv
fertilement	fertilement	Adv
fervemment	fervemment	Adv
fichtrement	fichtrement	Adv
fictivement	fictivement	Adv
fidelement	fidelement	Adv
fiduciairement	fiduciairement	Adv
fierement	fierement	Adv
fievreusement	fievreusement	Adv
fifty-fifty	fifty-fifty	Adv
figurativement	figurativement	Adv
figurement	figurement	Adv
filialement	filialement	Adv
finalement	finalement	Adv
financierement	financierement	Adv
finement	finement	Adv
fin	fin	Adv
fiscalement	fiscalement	Adv
fixement	fixement	Adv
flatteusement	flatteusement	Adv
flegmatiquement	flegmatiquement	Adv
flou	flou	Adv
follement	follement	Adv
foncierement	foncierement	Adv
fondamentalement	fondamentalement	Adv
forcement	forcement	Adv
forfaitairement	forfaitairement	Adv
formellement	formellement	Adv
formidablement	formidablement	Adv
forte	forte	Adv
fortement	fortement	Adv
fort	fort	Adv
fortissimo	fortissimo	Adv
fortuitement	fortuitement	Adv
fougueusement	fougueusement	Adv
foutrement	foutrement	Adv
fragmentairement	fragmentairement	Adv
fraichement	fraichement	Adv
franc	franc	Adv
franchement	franchement	Adv
franco	franco	Adv
fraternellement	fraternellement	Adv
frauduleusement	frauduleusement	Adv
frenetiquement	frenetiquement	Adv
frequemment	frequemment	Adv
frigo	frigo	Adv
frileusement	frileusement	Adv
frisquet	frisquet	Adv
frivolement	frivolement	Adv
froidement	froidement	Adv
fructueusement	fructueusement	Adv
frugalement	frugalement	Adv
fugitivement	fugitivement	Adv
funestement	funestement	Adv
furieusement	furieusement	Adv
furioso	furioso	Adv
furtivement	furtivement	Adv
futilement	futilement	Adv
gaiement	gaiement	Adv
gaillardement	gaillardement	Adv
gaiment	gaiment	Adv
galamment	galamment	Adv
galvaniquement	galvaniquement	Adv
gauchement	gauchement	Adv
gauloisement	gauloisement	Adv
genealogiquement	genealogiquement	Adv
generalement	generalement	Adv
genereusement	genereusement	Adv
genetiquement	genetiquement	Adv
genialement	genialement	Adv
gentiment	gentiment	Adv
geographiquement	geographiquement	Adv
geologiquement	geologiquement	Adv
geometriquement	geometriquement	Adv
gigantesquement	gigantesquement	Adv
glacialement	glacialement	Adv
globalement	globalement	Adv
glorieusement	glorieusement	Adv
gloutonnement	gloutonnement	Adv
goulument	goulument	Adv
gracieusement	gracieusement	Adv
graduellement	graduellement	Adv
grammaticalement	grammaticalement	Adv
grandement	grandement	Adv
grand	grand	Adv
grandiosement	grandiosement	Adv
graphiquement	graphiquement	Adv
gras	gras	Adv
grassement	grassement	Adv
gratis	gratis	Adv
gratuitement	gratuitement	Adv
grave	grave	Adv
gravement	gravement	Adv
grievement	grievement	Adv
grivoisement	grivoisement	Adv
grossement	grossement	Adv
grossierement	grossierement	Adv
grotesquement	grotesquement	Adv
guere	guere	Adv
gueres	gueres	Adv
habilement	habilement	Adv
habituellement	habituellement	Adv
haineusement	haineusement	Adv
hardiment	hardiment	Adv
hargneusement	hargneusement	Adv
harmonieusement	harmonieusement	Adv
harmoniquement	harmoniquement	Adv
hativement	hativement	Adv
hautement	hautement	Adv
haut	haut	Adv
hebdomadairement	hebdomadairement	Adv
hereditairement	hereditairement	Adv
hermetiquement	hermetiquement	Adv
heroiquement	heroiquement	Adv
heureusement	heureusement	Adv
hideusement	hideusement	Adv
hierarchiquement	hierarchiquement	Adv
hieratiquement	hieratiquement	Adv
hier	hier	Adv
histologiquement	histologiquement	Adv
historiquement	historiquement	Adv
honnetement	honnetement	Adv
honorablement	honorablement	Adv
honteusement	honteusement	Adv
horizontalement	horizontalement	Adv
horriblement	horriblement	Adv
hors	hors	Adv
hostilement	hostilement	Adv
huitiemement	huitiemement	Adv
humainement	humainement	Adv
humblement	humblement	Adv
hygieniquement	hygieniquement	Adv
hyperboliquement	hyperboliquement	Adv
hypocritement	hypocritement	Adv
hypothecairement	hypothecairement	Adv
hypothetiquement	hypothetiquement	Adv
ibidem	ibidem	Adv
ici	ici	Adv
idealement	idealement	Adv
idem	idem	Adv
identiquement	identiquement	Adv
ideologiquement	ideologiquement	Adv
idiotement	idiotement	Adv
idolatrement	idolatrement	Adv
ignoblement	ignoblement	Adv
ignominieusement	ignominieusement	Adv
illegalement	illegalement	Adv
illegitimement	illegitimement	Adv
illicitement	illicitement	Adv
illico	illico	Adv
illisiblement	illisiblement	Adv
illogiquement	illogiquement	Adv
illusoirement	illusoirement	Adv
imbecilement	imbecilement	Adv
immanquablement	immanquablement	Adv
immediatement	immediatement	Adv
immensement	immensement	Adv
immoderement	immoderement	Adv
immoralement	immoralement	Adv
immortellement	immortellement	Adv
immuablement	immuablement	Adv
imparfaitement	imparfaitement	Adv
impartialement	impartialement	Adv
impassiblement	impassiblement	Adv
impatiemment	impatiemment	Adv
impavidement	impavidement	Adv
impeccablement	impeccablement	Adv
imperativement	imperativement	Adv
imperceptiblement	imperceptiblement	Adv
imperialement	imperialement	Adv
imperieusement	imperieusement	Adv
impersonnellement	impersonnellement	Adv
impertinemment	impertinemment	Adv
imperturbablement	imperturbablement	Adv
impetueusement	impetueusement	Adv
impitoyablement	impitoyablement	Adv
implacablement	implacablement	Adv
implicitement	implicitement	Adv
impoliment	impoliment	Adv
imprevisiblement	imprevisiblement	Adv
impromptu	impromptu	Adv
improprement	improprement	Adv
imprudemment	imprudemment	Adv
impudemment	impudemment	Adv
impudiquement	impudiquement	Adv
impulsivement	impulsivement	Adv
impunement	impunement	Adv
incessamment	incessamment	Adv
incestueusement	incestueusement	Adv
incidemment	incidemment	Adv
incisivement	incisivement	Adv
inclusivement	inclusivement	Adv
incoerciblement	incoerciblement	Adv
incognito	incognito	Adv
incommensurablement	incommensurablement	Adv
incommodement	incommodement	Adv
incomparablement	incomparablement	Adv
incompletement	incompletement	Adv
incomprehensiblement	incomprehensiblement	Adv
inconcevablement	inconcevablement	Adv
inconditionnellement	inconditionnellement	Adv
inconfortablement	inconfortablement	Adv
incongrument	incongrument	Adv
inconsciemment	inconsciemment	Adv
inconsiderement	inconsiderement	Adv
inconstitutionnellement	inconstitutionnellement	Adv
incontestablement	incontestablement	Adv
incontinent	incontinent	Adv
incorrectement	incorrectement	Adv
incorrigiblement	incorrigiblement	Adv
incorruptiblement	incorruptiblement	Adv
incroyablement	incroyablement	Adv
incurablement	incurablement	Adv
indefectiblement	indefectiblement	Adv
indefiniment	indefiniment	Adv
indeniablement	indeniablement	Adv
independamment	independamment	Adv
indestructiblement	indestructiblement	Adv
indiciblement	indiciblement	Adv
indifferemment	indifferemment	Adv
indignement	indignement	Adv
indirectement	indirectement	Adv
indiscretement	indiscretement	Adv
indiscutablement	indiscutablement	Adv
indissolublement	indissolublement	Adv
indistinctement	indistinctement	Adv
individuellement	individuellement	Adv
indivisement	indivisement	Adv
indivisiblement	indivisiblement	Adv
indolemment	indolemment	Adv
indubitablement	indubitablement	Adv
indument	indument	Adv
industriellement	industriellement	Adv
industrieusement	industrieusement	Adv
inebranlablement	inebranlablement	Adv
ineffablement	ineffablement	Adv
inefficacement	inefficacement	Adv
inegalement	inegalement	Adv
ineluctablement	ineluctablement	Adv
inepuisablement	inepuisablement	Adv
inevitablement	inevitablement	Adv
inexactement	inexactement	Adv
inexorablement	inexorablement	Adv
inexplicablement	inexplicablement	Adv
inextricablement	inextricablement	Adv
infailliblement	infailliblement	Adv
infatigablement	infatigablement	Adv
inferieurement	inferieurement	Adv
infidelement	infidelement	Adv
infiniment	infiniment	Adv
inflexiblement	inflexiblement	Adv
infra	infra	Adv
infructueusement	infructueusement	Adv
ingenieusement	ingenieusement	Adv
ingenument	ingenument	Adv
ingratement	ingratement	Adv
inhumainement	inhumainement	Adv
inintelligemment	inintelligemment	Adv
inintelligiblement	inintelligiblement	Adv
iniquement	iniquement	Adv
initialement	initialement	Adv
injurieusement	injurieusement	Adv
injustement	injustement	Adv
inlassablement	inlassablement	Adv
innocemment	innocemment	Adv
inopinement	inopinement	Adv
inopportunement	inopportunement	Adv
insatiablement	insatiablement	Adv
insensiblement	insensiblement	Adv
inseparablement	inseparablement	Adv
insidieusement	insidieusement	Adv
insolemment	insolemment	Adv
instamment	instamment	Adv
instantanement	instantanement	Adv
instinctivement	instinctivement	Adv
insuffisamment	insuffisamment	Adv
insupportablement	insupportablement	Adv
intarissablement	intarissablement	Adv
integralement	integralement	Adv
intellectuellement	intellectuellement	Adv
intelligemment	intelligemment	Adv
intelligiblement	intelligiblement	Adv
intempestivement	intempestivement	Adv
intensement	intensement	Adv
intensivement	intensivement	Adv
intentionnellement	intentionnellement	Adv
interieurement	interieurement	Adv
interminablement	interminablement	Adv
interrogativement	interrogativement	Adv
intimement	intimement	Adv
intransitivement	intransitivement	Adv
intrepidement	intrepidement	Adv
intrinsequement	intrinsequement	Adv
intuitivement	intuitivement	Adv
inutilement	inutilement	Adv
invariablement	invariablement	Adv
inversement	inversement	Adv
invinciblement	invinciblement	Adv
inviolablement	inviolablement	Adv
invisiblement	invisiblement	Adv
involontairement	involontairement	Adv
ironiquement	ironiquement	Adv
irrationnellement	irrationnellement	Adv
irreductiblement	irreductiblement	Adv
irreellement	irreellement	Adv
irrefutablement	irrefutablement	Adv
irregulierement	irregulierement	Adv
irremediablement	irremediablement	Adv
irremissiblement	irremissiblement	Adv
irreparablement	irreparablement	Adv
irreprochablement	irreprochablement	Adv
irresistiblement	irresistiblement	Adv
irrespectueusement	irrespectueusement	Adv
irreverencieusement	irreverencieusement	Adv
irreversiblement	irreversiblement	Adv
irrevocablement	irrevocablement	Adv
isolement	isolement	Adv
isothermiquement	isothermiquement	Adv
item	item	Adv
iterativement	iterativement	Adv
itou	itou	Adv
jadis	jadis	Adv
jalousement	jalousement	Adv
jamais	jamais	Adv
jaune	jaune	Adv
jesuitiquement	jesuitiquement	Adv
jeudi	jeudi	Adv
jeunement	jeunement	Adv
joliment	joliment	Adv
journellement	journellement	Adv
jovialement	jovialement	Adv
joyeusement	joyeusement	Adv
judiciairement	judiciairement	Adv
judicieusement	judicieusement	Adv
juridiquement	juridiquement	Adv
juste	juste	Adv
justement	justement	Adv
laborieusement	laborieusement	Adv
lachement	lachement	Adv
laconiquement	laconiquement	Adv
laidement	laidement	Adv
la	la	Adv
lamentablement	lamentablement	Adv
langoureusement	langoureusement	Adv
languissamment	languissamment	Adv
large	large	Adv
largement	largement	Adv
larghetto	larghetto	Adv
largo	largo	Adv
lascivement	lascivement	Adv
lateralement	lateralement	Adv
legalement	legalement	Adv
legato	legato	Adv
legerement	legerement	Adv
legislativement	legislativement	Adv
legitimement	legitimement	Adv
lentement	lentement	Adv
lento	lento	Adv
lerche	lerche	Adv
lestement	lestement	Adv
liberalement	liberalement	Adv
librement	librement	Adv
licitement	licitement	Adv
limitativement	limitativement	Adv
lineairement	lineairement	Adv
linguistiquement	linguistiquement	Adv
lisiblement	lisiblement	Adv
litterairement	litterairement	Adv
litteralement	litteralement	Adv
localement	localement	Adv
logiquement	logiquement	Adv
loin	loin	Adv
longitudinalement	longitudinalement	Adv
long	long	Adv
longtemps	longtemps	Adv
longuement	longuement	Adv
lors	lors	Adv
lourdement	lourdement	Adv
lourd	lourd	Adv
loyalement	loyalement	Adv
lubriquement	lubriquement	Adv
lucidement	lucidement	Adv
lucrativement	lucrativement	Adv
lugubrement	lugubrement	Adv
lumineusement	lumineusement	Adv
lundi	lundi	Adv
luxueusement	luxueusement	Adv
lyriquement	lyriquement	Adv
macache	macache	Adv
machinalement	machinalement	Adv
macroscopiquement	macroscopiquement	Adv
maestoso	maestoso	Adv
magiquement	magiquement	Adv
magistralement	magistralement	Adv
magnanimement	magnanimement	Adv
magnetiquement	magnetiquement	Adv
magnifiquement	magnifiquement	Adv
maigrement	maigrement	Adv
maintenant	maintenant	Adv
mais	mais	Adv
majestueusement	majestueusement	Adv
majoritairement	majoritairement	Adv
maladivement	maladivement	Adv
maladroitement	maladroitement	Adv
malaisement	malaisement	Adv
malencontreusement	malencontreusement	Adv
malhabilement	malhabilement	Adv
malheureusement	malheureusement	Adv
malhonnetement	malhonnetement	Adv
malicieusement	malicieusement	Adv
mal	mal	Adv
malproprement	malproprement	Adv
manifestement	manifestement	Adv
manuellement	manuellement	Adv
mardi	mardi	Adv
marginalement	marginalement	Adv
maritalement	maritalement	Adv
marre	marre	Adv
martialement	martialement	Adv
massivement	massivement	Adv
materiellement	materiellement	Adv
maternellement	maternellement	Adv
mathematiquement	mathematiquement	Adv
matinalement	matinalement	Adv
matin	matin	Adv
matrimonialement	matrimonialement	Adv
maussadement	maussadement	Adv
mauvais	mauvais	Adv
mecaniquement	mecaniquement	Adv
mechamment	mechamment	Adv
mediatement	mediatement	Adv
medicalement	medicalement	Adv
mediocrement	mediocrement	Adv
meilleur	meilleur	Adv
melancoliquement	melancoliquement	Adv
melodieusement	melodieusement	Adv
melodiquement	melodiquement	Adv
meme	meme	Adv
memement	memement	Adv
mensongerement	mensongerement	Adv
mensuellement	mensuellement	Adv
mentalement	mentalement	Adv
menu	menu	Adv
mercredi	mercredi	Adv
merveilleusement	merveilleusement	Adv
mesquinement	mesquinement	Adv
mesurement	mesurement	Adv
metaphoriquement	metaphoriquement	Adv
metaphysiquement	metaphysiquement	Adv
methodiquement	methodiquement	Adv
meticuleusement	meticuleusement	Adv
mezzo	mezzo	Adv
mielleusement	mielleusement	Adv
miette	miette	Adv
mievrement	mievrement	Adv
mignonnement	mignonnement	Adv
militairement	militairement	Adv
minablement	minablement	Adv
minutieusement	minutieusement	Adv
miraculeusement	miraculeusement	Adv
mirifiquement	mirifiquement	Adv
miserablement	miserablement	Adv
misericordieusement	misericordieusement	Adv
moderato	moderato	Adv
moderement	moderement	Adv
modestement	modestement	Adv
modiquement	modiquement	Adv
moelleusement	moelleusement	Adv
moindrement	moindrement	Adv
moins	moins	Adv
mollement	mollement	Adv
mollo	mollo	Adv
momentanement	momentanement	Adv
mondialement	mondialement	Adv
monstrueusement	monstrueusement	Adv
moqueusement	moqueusement	Adv
moralement	moralement	Adv
mordicus	mordicus	Adv
morganatiquement	morganatiquement	Adv
morphologiquement	morphologiquement	Adv
mortellement	mortellement	Adv
moult	moult	Adv
moyennement	moyennement	Adv
muettement	muettement	Adv
murement	murement	Adv
musicalement	musicalement	Adv
mutuellement	mutuellement	Adv
mysterieusement	mysterieusement	Adv
mystiquement	mystiquement	Adv
naguere	naguere	Adv
naivement	naivement	Adv
narquoisement	narquoisement	Adv
nativement	nativement	Adv
naturellement	naturellement	Adv
nature	nature	Adv
neanmoins	neanmoins	Adv
necessairement	necessairement	Adv
negatif	negatif	Adv
negativement	negativement	Adv
negligemment	negligemment	Adv
nenni	nenni	Adv
nerveusement	nerveusement	Adv
net	net	Adv
nettement	nettement	Adv
neuviemement	neuviemement	Adv
niaisement	niaisement	Adv
nib	nib	Adv
ni	ni	Adv
noblement	noblement	Adv
nominalement	nominalement	Adv
nominativement	nominativement	Adv
nommement	nommement	Adv
nonchalamment	nonchalamment	Adv
non	non	Adv
nonobstant	nonobstant	Adv
normalement	normalement	Adv
nostalgiquement	nostalgiquement	Adv
notablement	notablement	Adv
notamment	notamment	Adv
notoirement	notoirement	Adv
nouvellement	nouvellement	Adv
nuisiblement	nuisiblement	Adv
nuitamment	nuitamment	Adv
nullement	nullement	Adv
nument	nument	Adv
numeriquement	numeriquement	Adv
objectivement	objectivement	Adv
obligatoirement	obligatoirement	Adv
obligeamment	obligeamment	Adv
obliquement	obliquement	Adv
obscurement	obscurement	Adv
obsequieusement	obsequieusement	Adv
obstinement	obstinement	Adv
occasionnellement	occasionnellement	Adv
occultement	occultement	Adv
octavo	octavo	Adv
odieusement	odieusement	Adv
offensivement	offensivement	Adv
officiellement	officiellement	Adv
officieusement	officieusement	Adv
oiseusement	oiseusement	Adv
oisivement	oisivement	Adv
onc	onc	Adv
oncques	oncques	Adv
onctueusement	onctueusement	Adv
onereusement	onereusement	Adv
onques	onques	Adv
ontologiquement	ontologiquement	Adv
onziemement	onziemement	Adv
opaquement	opaquement	Adv
opiniatrement	opiniatrement	Adv
opportunement	opportunement	Adv
opulemment	opulemment	Adv
orageusement	orageusement	Adv
oralement	oralement	Adv
ordinairement	ordinairement	Adv
ores	ores	Adv
organiquement	organiquement	Adv
orgueilleusement	orgueilleusement	Adv
originairement	originairement	Adv
originalement	originalement	Adv
originellement	originellement	Adv
orthogonalement	orthogonalement	Adv
ostensiblement	ostensiblement	Adv
oui	oui	Adv
out	out	Adv
outrageusement	outrageusement	Adv
outre	outre	Adv
outre-mer	outre-mer	Adv
ouvertement	ouvertement	Adv
pacifiquement	pacifiquement	Adv
paillardement	paillardement	Adv
pairement	pairement	Adv
paisiblement	paisiblement	Adv
paraboliquement	paraboliquement	Adv
paradoxalement	paradoxalement	Adv
parallelement	parallelement	Adv
parcimonieusement	parcimonieusement	Adv
pardon	pardon	Adv
pareillement	pareillement	Adv
paresseusement	paresseusement	Adv
parfaitement	parfaitement	Adv
parfois	parfois	Adv
parlementairement	parlementairement	Adv
partialement	partialement	Adv
particulierement	particulierement	Adv
partiellement	partiellement	Adv
partout	partout	Adv
par-ci	par-ci	Adv
par-derriere	par-derriere	Adv
par-dessous	par-dessous	Adv
par-dessus	par-dessus	Adv
par-devant	par-devant	Adv
par-devers	par-devers	Adv
pas	pas	Adv
passablement	passablement	Adv
passagerement	passagerement	Adv
passim	passim	Adv
passionnement	passionnement	Adv
passivement	passivement	Adv
paternellement	paternellement	Adv
pathetiquement	pathetiquement	Adv
pathologiquement	pathologiquement	Adv
patiemment	patiemment	Adv
patriarcalement	patriarcalement	Adv
patriotiquement	patriotiquement	Adv
pauvrement	pauvrement	Adv
pecuniairement	pecuniairement	Adv
pedagogiquement	pedagogiquement	Adv
pedestrement	pedestrement	Adv
peinardement	peinardement	Adv
pejorativement	pejorativement	Adv
penalement	penalement	Adv
penardement	penardement	Adv
peniblement	peniblement	Adv
pensivement	pensivement	Adv
perceptiblement	perceptiblement	Adv
peremptoirement	peremptoirement	Adv
perfidement	perfidement	Adv
perilleusement	perilleusement	Adv
periodiquement	periodiquement	Adv
pernicieusement	pernicieusement	Adv
perpendiculairement	perpendiculairement	Adv
perpetuellement	perpetuellement	Adv
personnellement	personnellement	Adv
pertinemment	pertinemment	Adv
perversement	perversement	Adv
pesamment	pesamment	Adv
petitement	petitement	Adv
petit	petit	Adv
peu	peu	Adv
peureusement	peureusement	Adv
peut-etre	peut-etre	Adv
philologiquement	philologiquement	Adv
philosophiquement	philosophiquement	Adv
phonetiquement	phonetiquement	Adv
photographiquement	photographiquement	Adv
physiologiquement	physiologiquement	Adv
physiquement	physiquement	Adv
pianissimo	pianissimo	Adv
piano	piano	Adv
pietrement	pietrement	Adv
pieusement	pieusement	Adv
pile	pile	Adv
piteusement	piteusement	Adv
pitoyablement	pitoyablement	Adv
pittoresquement	pittoresquement	Adv
placidement	placidement	Adv
plaintivement	plaintivement	Adv
plaisamment	plaisamment	Adv
planetairement	planetairement	Adv
plantureusement	plantureusement	Adv
plastiquement	plastiquement	Adv
platement	platement	Adv
platoniquement	platoniquement	Adv
plat	plat	Adv
plausiblement	plausiblement	Adv
pleinement	pleinement	Adv
plus	plus	Adv
plutot	plutot	Adv
poetiquement	poetiquement	Adv
point	point	Adv
pointu	pointu	Adv
poliment	poliment	Adv
politiquement	politiquement	Adv
pompeusement	pompeusement	Adv
ponctuellement	ponctuellement	Adv
populairement	populairement	Adv
posement	posement	Adv
positivement	positivement	Adv
possiblement	possiblement	Adv
posterieurement	posterieurement	Adv
potentiellement	potentiellement	Adv
pourquoi	pourquoi	Adv
pourtant	pourtant	Adv
poussivement	poussivement	Adv
pratiquement	pratiquement	Adv
prealablement	prealablement	Adv
precairement	precairement	Adv
precautionneusement	precautionneusement	Adv
precedemment	precedemment	Adv
precieusement	precieusement	Adv
precipitamment	precipitamment	Adv
precisement	precisement	Adv
precocement	precocement	Adv
preferablement	preferablement	Adv
preferentiellement	preferentiellement	Adv
preliminairement	preliminairement	Adv
prematurement	prematurement	Adv
premierement	premierement	Adv
prepositivement	prepositivement	Adv
presentement	presentement	Adv
presomptueusement	presomptueusement	Adv
presque	presque	Adv
prestement	prestement	Adv
prestissimo	prestissimo	Adv
presto	presto	Adv
pretendument	pretendument	Adv
pretentieusement	pretentieusement	Adv
preventivement	preventivement	Adv
primitivement	primitivement	Adv
primo	primo	Adv
primordialement	primordialement	Adv
princierement	princierement	Adv
principalement	principalement	Adv
probablement	probablement	Adv
problematiquement	problematiquement	Adv
processionnellement	processionnellement	Adv
prochainement	prochainement	Adv
proche	proche	Adv
prodigieusement	prodigieusement	Adv
professionnellement	professionnellement	Adv
profitablement	profitablement	Adv
profondement	profondement	Adv
profond	profond	Adv
profusement	profusement	Adv
progressivement	progressivement	Adv
proletairement	proletairement	Adv
promptement	promptement	Adv
pronominalement	pronominalement	Adv
prophetiquement	prophetiquement	Adv
proportionnellement	proportionnellement	Adv
proprement	proprement	Adv
prosaiquement	prosaiquement	Adv
prou	prou	Adv
proverbialement	proverbialement	Adv
providentiellement	providentiellement	Adv
provincialement	provincialement	Adv
provisoirement	provisoirement	Adv
prudemment	prudemment	Adv
psychologiquement	psychologiquement	Adv
publicitairement	publicitairement	Adv
publiquement	publiquement	Adv
pudiquement	pudiquement	Adv
puerilement	puerilement	Adv
puis	puis	Adv
puissamment	puissamment	Adv
purement	purement	Adv
pyramidalement	pyramidalement	Adv
qualitativement	qualitativement	Adv
quand	quand	Adv
quantitativement	quantitativement	Adv
quarante	quarante	Adv
quarto	quarto	Adv
quasiment	quasiment	Adv
quasi	quasi	Adv
quater	quater	Adv
quatorziemement	quatorziemement	Adv
quatriemement	quatriemement	Adv
quelquefois	quelquefois	Adv
quietement	quietement	Adv
quinto	quinto	Adv
quinziemement	quinziemement	Adv
quoique	quoique	Adv
quotidiennement	quotidiennement	Adv
radicalement	radicalement	Adv
radieusement	radieusement	Adv
rageusement	rageusement	Adv
raisonnablement	raisonnablement	Adv
rapidement	rapidement	Adv
rarement	rarement	Adv
rasibus	rasibus	Adv
ras	ras	Adv
rationnellement	rationnellement	Adv
realistement	realistement	Adv
recemment	recemment	Adv
reciproquement	reciproquement	Adv
recta	recta	Adv
reellement	reellement	Adv
reflexivement	reflexivement	Adv
reglementairement	reglementairement	Adv
reglo	reglo	Adv
regrettablement	regrettablement	Adv
regulierement	regulierement	Adv
relativement	relativement	Adv
religieusement	religieusement	Adv
remarquablement	remarquablement	Adv
resolument	resolument	Adv
respectivement	respectivement	Adv
respectueusement	respectueusement	Adv
retroactivement	retroactivement	Adv
retrospectivement	retrospectivement	Adv
reverencieusement	reverencieusement	Adv
reveusement	reveusement	Adv
revolutionnairement	revolutionnairement	Adv
richement	richement	Adv
ric-rac	ric-rac	Adv
ridiculement	ridiculement	Adv
rigidement	rigidement	Adv
rigoureusement	rigoureusement	Adv
rinforzando	rinforzando	Adv
risiblement	risiblement	Adv
ritardando	ritardando	Adv
rituellement	rituellement	Adv
robustement	robustement	Adv
rogatoirement	rogatoirement	Adv
romanesquement	romanesquement	Adv
romantiquement	romantiquement	Adv
rondement	rondement	Adv
rond	rond	Adv
rouge	rouge	Adv
royalement	royalement	Adv
rubato	rubato	Adv
rudement	rudement	Adv
rudimentairement	rudimentairement	Adv
ruineusement	ruineusement	Adv
rustiquement	rustiquement	Adv
rythmiquement	rythmiquement	Adv
sacrement	sacrement	Adv
sadiquement	sadiquement	Adv
sagement	sagement	Adv
sainement	sainement	Adv
saintement	saintement	Adv
salement	salement	Adv
salutairement	salutairement	Adv
samedi	samedi	Adv
sarcastiquement	sarcastiquement	Adv
sardoniquement	sardoniquement	Adv
satiriquement	satiriquement	Adv
sauvagement	sauvagement	Adv
savamment	savamment	Adv
savoureusement	savoureusement	Adv
scandaleusement	scandaleusement	Adv
sceniquement	sceniquement	Adv
sceptiquement	sceptiquement	Adv
schematiquement	schematiquement	Adv
schuss	schuss	Adv
sciemment	sciemment	Adv
scientifiquement	scientifiquement	Adv
scolairement	scolairement	Adv
scolastiquement	scolastiquement	Adv
scrupuleusement	scrupuleusement	Adv
sechement	sechement	Adv
secondairement	secondairement	Adv
secondement	secondement	Adv
secretement	secretement	Adv
sec	sec	Adv
seculairement	seculairement	Adv
seculierement	seculierement	Adv
secundo	secundo	Adv
seditieusement	seditieusement	Adv
seiziemement	seiziemement	Adv
selectivement	selectivement	Adv
semblablement	semblablement	Adv
semestriellement	semestriellement	Adv
sempiternellement	sempiternellement	Adv
senestrorsum	senestrorsum	Adv
sensement	sensement	Adv
sensiblement	sensiblement	Adv
sensuellement	sensuellement	Adv
sentencieusement	sentencieusement	Adv
sentimentalement	sentimentalement	Adv
separement	separement	Adv
septiemement	septiemement	Adv
septimo	septimo	Adv
sereinement	sereinement	Adv
serieusement	serieusement	Adv
serre	serre	Adv
servilement	servilement	Adv
seulement	seulement	Adv
seul	seul	Adv
severement	severement	Adv
sforzando	sforzando	Adv
sic	sic	Adv
significativement	significativement	Adv
silencieusement	silencieusement	Adv
simplement	simplement	Adv
simultanement	simultanement	Adv
sincerement	sincerement	Adv
singulierement	singulierement	Adv
sinistrement	sinistrement	Adv
si	si	Adv
sitot	sitot	Adv
sixiemement	sixiemement	Adv
smorzando	smorzando	Adv
sobrement	sobrement	Adv
socialement	socialement	Adv
sociologiquement	sociologiquement	Adv
soigneusement	soigneusement	Adv
soir	soir	Adv
soirs	soit	Adv
soldatesquement	soldatesquement	Adv
solennellement	solennellement	Adv
solidairement	solidairement	Adv
solidement	solidement	Adv
solitairement	solitairement	Adv
somatiquement	somatiquement	Adv
sombrement	sombrement	Adv
sommairement	sommairement	Adv
somptueusement	somptueusement	Adv
sordidement	sordidement	Adv
sostenuto	sostenuto	Adv
sottement	sottement	Adv
soucieusement	soucieusement	Adv
soudainement	soudainement	Adv
soudain	soudain	Adv
soupconneusement	soupconneusement	Adv
souplement	souplement	Adv
sourdement	sourdement	Adv
sournoisement	sournoisement	Adv
souterrainement	souterrainement	Adv
souvent	souvent	Adv
souverainement	souverainement	Adv
spacieusement	spacieusement	Adv
spasmodiquement	spasmodiquement	Adv
spatialement	spatialement	Adv
specialement	specialement	Adv
specieusement	specieusement	Adv
specifiquement	specifiquement	Adv
speculativement	speculativement	Adv
spirituellement	spirituellement	Adv
splendidement	splendidement	Adv
spontanement	spontanement	Adv
sporadiquement	sporadiquement	Adv
sportivement	sportivement	Adv
staccato	staccato	Adv
statistiquement	statistiquement	Adv
statutairement	statutairement	Adv
stenographiquement	stenographiquement	Adv
sterilement	sterilement	Adv
stoiquement	stoiquement	Adv
strategiquement	strategiquement	Adv
strictement	strictement	Adv
structuralement	structuralement	Adv
studieusement	studieusement	Adv
stupidement	stupidement	Adv
suavement	suavement	Adv
subitement	subitement	Adv
subito	subito	Adv
subjectivement	subjectivement	Adv
sublimement	sublimement	Adv
subrepticement	subrepticement	Adv
subsequemment	subsequemment	Adv
subsidiairement	subsidiairement	Adv
substantiellement	substantiellement	Adv
substantivement	substantivement	Adv
subtilement	subtilement	Adv
subversivement	subversivement	Adv
suffisamment	suffisamment	Adv
superbement	superbement	Adv
superficiellement	superficiellement	Adv
superieurement	superieurement	Adv
superlativement	superlativement	Adv
superstitieusement	superstitieusement	Adv
supplementairement	supplementairement	Adv
supra	supra	Adv
supremement	supremement	Adv
surabondamment	surabondamment	Adv
surement	surement	Adv
surhumainement	surhumainement	Adv
sur	sur	Adv
surtout	surtout	Adv
sur-le-champ	sur-le-champ	Adv
suspens	suspens	Adv
suspicieusement	suspicieusement	Adv
sus	sus	Adv
symboliquement	symboliquement	Adv
symetriquement	symetriquement	Adv
sympathiquement	sympathiquement	Adv
symptomatiquement	symptomatiquement	Adv
synchroniquement	synchroniquement	Adv
synthetiquement	synthetiquement	Adv
systematiquement	systematiquement	Adv
tacitement	tacitement	Adv
tactiquement	tactiquement	Adv
talentueusement	talentueusement	Adv
tangentiellement	tangentiellement	Adv
tangiblement	tangiblement	Adv
tantot	tantot	Adv
tant	tant	Adv
tapageusement	tapageusement	Adv
tardivement	tardivement	Adv
tard	tard	Adv
techniquement	techniquement	Adv
technocratiquement	technocratiquement	Adv
tectoniquement	tectoniquement	Adv
telegraphiquement	telegraphiquement	Adv
telephoniquement	telephoniquement	Adv
tellement	tellement	Adv
temerairement	temerairement	Adv
tempetueusement	tempetueusement	Adv
temporairement	temporairement	Adv
temporellement	temporellement	Adv
tenacement	tenacement	Adv
tendancieusement	tendancieusement	Adv
tendrement	tendrement	Adv
tenebreusement	tenebreusement	Adv
tenuto	tenuto	Adv
terriblement	terriblement	Adv
terrible	terrible	Adv
territorialement	territorialement	Adv
ter	ter	Adv
tertio	tertio	Adv
tete-beche	tete-beche	Adv
textuellement	textuellement	Adv
theatralement	theatralement	Adv
theologiquement	theologiquement	Adv
theoriquement	theoriquement	Adv
tiedement	tiedement	Adv
timidement	timidement	Adv
topographiquement	topographiquement	Adv
torrentiellement	torrentiellement	Adv
tortueusement	tortueusement	Adv
totalement	totalement	Adv
tot	tot	Adv
toujours	toujours	Adv
toutefois	toutefois	Adv
toute	toute	Adv
tout	tout	Adv
traditionnellement	traditionnellement	Adv
tragiquement	tragiquement	Adv
traitreusement	traitreusement	Adv
tranquillement	tranquillement	Adv
transitivement	transitivement	Adv
transitoirement	transitoirement	Adv
transversalement	transversalement	Adv
treiziemement	treiziemement	Adv
trentiemement	trentiemement	Adv
tres	tres	Adv
trigonometriquement	trigonometriquement	Adv
trimestriellement	trimestriellement	Adv
triomphalement	triomphalement	Adv
triplement	triplement	Adv
tristement	tristement	Adv
trivialement	trivialement	Adv
troisiemement	troisiemement	Adv
trompeusement	trompeusement	Adv
trop	trop	Adv
tumultueusement	tumultueusement	Adv
turpidement	turpidement	Adv
typiquement	typiquement	Adv
typographiquement	typographiquement	Adv
tyranniquement	tyranniquement	Adv
ulterieurement	ulterieurement	Adv
ultimo	ultimo	Adv
unanimement	unanimement	Adv
uniemement	uniemement	Adv
uniformement	uniformement	Adv
unilateralement	unilateralement	Adv
uniment	uniment	Adv
uniquement	uniquement	Adv
universellement	universellement	Adv
usuellement	usuellement	Adv
usurairement	usurairement	Adv
utilement	utilement	Adv
vachement	vachement	Adv
vaguement	vaguement	Adv
vaillamment	vaillamment	Adv
vainement	vainement	Adv
valablement	valablement	Adv
valeureusement	valeureusement	Adv
validement	validement	Adv
vaniteusement	vaniteusement	Adv
vaporeusement	vaporeusement	Adv
variablement	variablement	Adv
vaseusement	vaseusement	Adv
vastement	vastement	Adv
vegetativement	vegetativement	Adv
vehementement	vehementement	Adv
velocement	velocement	Adv
venalement	venalement	Adv
vendredi	vendredi	Adv
venerablement	venerablement	Adv
veniellement	veniellement	Adv
venimeusement	venimeusement	Adv
verbalement	verbalement	Adv
verbeusement	verbeusement	Adv
veridiquement	veridiquement	Adv
veritablement	veritablement	Adv
vertement	vertement	Adv
verticalement	verticalement	Adv
vertigineusement	vertigineusement	Adv
vertueusement	vertueusement	Adv
vice-versa	vice-versa	Adv
vicieusement	vicieusement	Adv
victorieusement	victorieusement	Adv
vigesimo	vigesimo	Adv
vigilamment	vigilamment	Adv
vigoureusement	vigoureusement	Adv
vilainement	vilainement	Adv
vilain	vilain	Adv
vilement	vilement	Adv
vindicativement	vindicativement	Adv
vingtiemement	vingtiemement	Adv
violemment	violemment	Adv
virginalement	virginalement	Adv
virilement	virilement	Adv
virtuellement	virtuellement	Adv
visceralement	visceralement	Adv
visiblement	visiblement	Adv
visuellement	visuellement	Adv
vite	vite	Adv
vivace	vivace	Adv
vivement	vivement	Adv
vocalement	vocalement	Adv
voici	voici	Adv
voila	voila	Adv
voire	voire	Adv
volontairement	volontairement	Adv
volontiers	volontiers	Adv
volubilement	volubilement	Adv
voluptueusement	voluptueusement	Adv
voracement	voracement	Adv
vraiment	vraiment	Adv
vraisemblablement	vraisemblablement	Adv
vrai	vrai	Adv
vulgairement	vulgairement	Adv
vulgo	vulgo	Adv
y	y	Adv
zoologiquement	zoologiquement	Adv
